

ROOM_BEGIN

ROOM_WIDTH(20)
ROOM_HEIGHT(15)
ROOM_TILES(
  1,  1,  1,  1,  1,  1,  1,  1,  1,  1,  1,  1,  1,  1,  1,  1,  1,  1,  1,  1,
  1,  0,  0,  0,  0,  0,  0,  0,  0,  0,  0,  0,  0,  0,  0,  0,  0,  0,  0,  1,
  1,  0,  0,  0,  0,  0,  0,  0,  0,  0,  0,  0,  0,  0,  0,  0,  0,  0,  0,  1,
  1,  0,  0,  0,  0,  0,  0,  0,  0,  0,  0,  0,  0,  0,  0,  0,  0,  0,  0,  1,
  1,  0,  0,  0,  0,  0,  0,  0,  0,  0,  0,  0,  0,  0,  0,  0,  0,  0,  0,  1,
  1,  0,  0,  0,  0,  0,  0,  0,  0,  0,  0,  0,  0,  0,  0,  0,  0,  0,  0,  1,
  1,  0,  0,  0,  0,  0,  0,  0,  0,  0,  0,  0,  0,  0,  0,  0,  0,  0,  0,  1,
  1,  0,  0,  0,  0,  0,  0,  0,  0,  0,  0,  0,  0,  0,  0,  0,  0,  0,  0,  1,
  1,  0,  0,  0,  0,  0,  0,  0,  0,  0,  0,  0,  0,  0,  0,  0,  0,  0,  0,  1,
  1,  0,  0,  0,  0,  0,  0,  0,  0,  0,  0,  0,  0,  0,  0,  0,  0,  0,  0,  1,
  1,  0,  0,  0,  0,  0,  0,  1,  1,  1,  1,  1,  1,  1,  1,  1,  0,  0,  0,  1,
  1,  0,  0,  0,  0,  0,  0,  5,  0,  5,  0,  5,  0,  5,  0,  5,  0,  0,  0,  0,
  1,  0,  0,  0,  0,  0,  0,  6,  0,  6,  0,  6,  0,  6,  0,  6,  0,  0,  0,  0,
  1,  0,  0,  0,  0,  0,  0,  6,  0,  6,  0,  6,  0,  6,  0,  6,  0,  0,  0,  0,
  1,  1,  1,  1,  1,  1,  1,  1,  1,  1,  1,  1,  1,  1,  1,  1,  1,  1,  1,  1,
)

ROOM_NNEIGHBORS(2)
ROOM_NEIGHBORS(
	room::test1,
	room::test2
)
ROOM_WALLS(LEFT|TOP|BOTTOM)

ROOM_END

