

ROOM_BEGIN

ROOM_POS(0, 0)
ROOM_WIDTH(20)
ROOM_HEIGHT(15)
ROOM_TILES(
  1,  1,  1,  1,  1,  1,  1,  1,  1,  1,  1,  1,  1,  1,  1,  1,  1,  1,  1,  1,
  1,  0,  0,  0,  0,  0,  0,  0,  0,  0,  0,  0,  0,  0,  0,  0,  0,  0,  0,  0,
  1,  0,  0,  0,  0,  0,  0,  0,  0,  0,  0,  0,  0,  0,  0,  0,  0,  0,  0,  0,
  1,  0,  0,  0,  0,  0,  0,  0,  0,  0,  0,  0,  0,  0,  0,  0,  0,  0,  0,  0,
  1,  0,  0,  0,  0,  0,  0,  0,  0,  0,  0,  0,  0,  0,  0,  0,  0,  0,  0,  0,
  1,  0,  0,  0,  0,  0,  0,  0,  0,  0,  0,  0,  0,  0,  0,  0,  0,  0,  0,  0,
  1,  0,  0,  0,  0,  0,  0,  0,  0,  0,  0,  0,  0,  0,  0,  0,  0,  0,  0,  0,
  1,  0,  0,  0,  0,  0,  0,  0,  0,  0,  0,  0,  0,  0,  0,  0,  0,  0,  0,  0,
  1,  0,  0,  0,  0,  0,  0,  0,  0,  0,  0,  0,  0,  0,  0,  0,  0,  0,  0,  0,
  1,  0,  0,  0,  0,  0,  0,  0,  0,  0,  0,  0,  0,  0,  0,  0,  0,  0,  0,  0,
  1,  0,  0,  0,  0,  0,  0,  1,  1,  1,  1,  1,  1,  1,  1,  1,  0,  0,  0,  0,
  1,  0,  0,  0,  0,  0,  0,  5,  0,  5,  0,  5,  0,  5,  0,  5,  0,  0,  0,  0,
  1,  0,  0,  0,  0,  0,  0,  6,  0,  6,  0,  6,  0,  6,  0,  6,  0,  0,  0,  0,
  1,  0,  0,  0,  0,  0,  0,  6,  0,  6,  0,  6,  0,  6,  0,  6,  0,  0,  0,  0,
  1,  1,  1,  1,  1,  1,  1,  1,  1,  1,  1,  1,  1,  1,  1,  1,  1,  1,  1,  1,
)

ROOM_N_NEIGHBORS(2)
ROOM_NEIGHBORS(
	room::test1,
	room::test2
)
ROOM_WALLS(LEFT|TOP|BOTTOM)

ROOM_INIT(
	new Tilemap(type::tilemap, THIS_ROOM);
	new BGColor(type::bg_color, THIS_ROOM, pos, Vec(width, height), 0x7f7f7fff);
	new Door(type::door, THIS_ROOM, pos+Vec(8.5, 1), room::test2, room::test2->pos+Vec(1.5, 21));
	new Item(type::item, THIS_ROOM, pos+Vec(8, 5), item::handgun);
)

ROOM_END

