
ROOM_BEGIN

ROOM_POS(0, 15)
ROOM_WIDTH(40)
ROOM_HEIGHT(30)
ROOM_TILES(
	1, 1, 1, 1, 1, 1, 1, 1, 1, 1, 1, 1, 1, 1, 1, 1, 1, 1, 1, 1, 1, 1, 1, 1, 1, 1, 1, 1, 1, 1, 1, 1, 1, 1, 1, 1, 1, 1, 1, 1,
	1, 0,-4,-2, 0, 0, 0, 0, 0, 0, 5, 0, 0, 0, 5, 0, 0, 0, 5, 0, 0, 0, 5, 0, 0, 0, 5, 0, 0, 0, 5, 0, 0, 0, 2, 4, 0, 0, 0, 1,
	1,-4,-3, 0, 0, 0, 0, 0, 0, 0, 6, 0, 0, 0, 6, 0, 0, 0, 6, 0, 0, 0, 6, 0, 0, 0, 6, 0, 0, 0, 6, 0, 0, 0, 0, 3, 4, 0, 0, 1,
	1,-3, 0, 0, 0, 0, 0, 0, 0, 0, 6, 0, 0, 0, 6, 0, 0, 0, 6, 0, 0, 0, 6, 0, 0, 0, 6, 0, 0, 0, 6, 0, 0, 0, 0, 0, 3, 4, 0, 1,
	1, 0, 0, 0, 0, 0, 0, 0, 0, 0, 6, 0, 0, 0, 6, 0, 0, 0, 6, 0, 0, 0, 6, 0, 0, 0, 6, 0, 0, 0, 6, 0, 0, 0, 0, 0, 0, 3, 4, 1,
	1, 1, 1, 0, 0, 0, 0, 0, 0, 0, 6, 0, 0, 0, 6, 0, 0, 0, 6, 0, 0, 0, 6, 0, 0, 0, 6, 0, 0, 0, 6, 0, 0, 0, 0, 0, 0, 0, 3, 1,
	1, 0, 5, 0, 0, 0, 0, 0, 0, 0, 6, 0, 0, 0, 6, 0, 0, 0, 6, 0, 0, 0, 6, 0, 0, 0, 6, 0, 0, 0, 6, 0, 0, 0, 0, 0, 0, 0, 0, 1,
	1, 0, 6, 0, 0, 0, 0, 0, 0, 0, 6, 0, 0, 0, 6, 0, 0, 0, 6, 0, 0, 0, 6, 0, 0, 0, 6, 0, 0, 0, 6, 0, 0, 0, 0, 0, 0, 0, 0, 1,
	1, 0, 6, 0, 0, 0, 0, 0, 0, 0, 6, 0, 0, 0, 6, 0, 0, 0, 6, 0, 0, 0, 6, 0, 0, 0, 6, 0, 0, 0, 6, 0, 0, 0, 0, 0, 0, 0, 0, 1,
	1, 1, 1, 0, 0, 0, 0, 1, 1, 1, 1, 1, 1, 1, 1, 1, 1, 1, 1, 1, 0, 1, 1, 1, 1, 1, 1, 1, 1, 1, 1, 1, 1, 0, 0, 0, 0, 0, 0, 1,
	1,-2, 0, 0, 0, 0, 0, 0, 5, 0, 0, 0, 5, 0, 0, 0, 0, 0, 0, 0, 0, 0, 0, 0, 0, 0, 0, 0, 0, 0, 0, 2, 4, 0, 0, 0, 0, 0, 0, 1,
	1, 0, 0, 0, 0, 0, 0, 0, 6, 0, 0, 0, 6, 0, 0, 0, 0, 0, 0, 0, 0, 0, 0, 0, 0, 0, 0, 0, 0, 0, 0, 0, 3, 4, 0, 0, 0, 0, 0, 1,
	1, 0, 0, 0, 0, 0, 0, 0, 6, 0, 0, 0, 6, 0, 0, 0, 0, 0, 0, 0, 0, 0, 0, 0, 0, 0, 0, 0, 0, 0, 0, 0, 0, 3, 4, 0, 0, 0, 0, 1,
	1, 0, 0, 0, 0, 1, 1, 1, 1, 1, 1, 1, 1, 1, 0, 0, 0, 0, 0, 0, 0, 0, 0, 0, 0, 0, 0, 0, 0, 0, 0, 0, 1, 1, 1, 1, 1, 1, 1, 1,
	1, 0, 0, 0, 0,-4,-2, 0, 5, 0, 0, 0, 5, 0, 0, 0, 0, 0, 0, 0, 0, 0, 0, 0, 0, 0, 0, 0, 0, 0, 0, 0, 1,-4,-2, 0, 0, 0, 2, 1,
	1, 0, 0, 0,-4,-3, 0, 0, 6, 0, 0, 0, 6, 0, 0, 0, 0, 0, 1, 1, 1, 1, 1, 1, 0, 0, 0, 0, 0, 0, 0, 0,-4,-3, 0, 0, 0, 0, 0, 1,
	1, 0, 0,-4,-3, 0, 0, 0, 6, 0, 0, 0, 6, 0, 0, 0, 0, 0, 1,-2, 0, 0, 2, 1, 0, 0, 0, 0, 0, 0, 0,-4,-3, 0, 0, 0, 0, 0, 0, 1,
	1, 1, 1, 1, 1, 0, 0, 0, 6, 0, 0, 0, 6, 0, 0, 0, 0, 0, 1, 0, 0, 0, 0, 1, 0, 0, 0, 0, 0, 0,-4,-3, 0, 0, 0, 0, 0, 0, 0, 1,
	1,-4,-2, 0, 0, 0, 0, 0, 6, 0, 0, 0, 6, 0, 0, 0, 0, 0, 6, 0, 0, 0, 0, 5, 0, 0, 0, 0, 0, 1, 1, 1, 1, 1, 1, 1, 1, 0, 0, 1,
	1,-3, 0, 0, 0, 0, 0, 0, 1, 4, 0, 0, 6, 0, 0, 0, 0, 0, 6, 0, 0, 0, 0, 6, 0, 0, 0, 0, 1, 1, 0, 0, 5, 0, 0, 5, 0, 0, 0, 1,
	1, 0, 0, 0, 0, 0, 0, 0, 0, 3, 4, 0, 6, 0, 0, 0, 0, 1, 1, 1, 1, 1, 1, 1, 1, 0, 0, 1, 1, 5, 0, 0, 6, 0, 0, 6, 0, 0, 0, 1,
	1, 0, 0, 0, 0, 0, 0, 0, 0, 0, 3, 4, 6, 0, 0, 0, 0, 0, 1, 1, 1, 1, 1, 1, 0, 0, 0, 0, 0, 6, 0, 0, 6, 0, 0, 6, 0, 0, 0, 1,
	1, 0, 0, 0, 0, 0, 0, 0, 0, 0, 0, 1, 1, 1, 1, 0, 0, 0, 0, 2, 1, 1,-2, 0, 0, 0, 0, 0, 0, 6, 0, 0, 6, 0, 0, 6, 0, 1, 1, 1,
	1, 0, 0, 0, 0, 0, 0, 0, 0, 0,-4,-2, 0, 0, 5, 0, 0, 0, 0, 0, 1, 1, 0, 0, 0, 0, 0, 0, 0, 6, 0, 0, 1, 0, 0, 6, 0, 0, 2, 1,
	1, 0, 0, 0, 0, 0, 0, 0, 0,-4,-3, 0, 0, 0, 6, 0, 0, 0, 0, 0, 1, 1, 0, 0, 0, 0, 0, 0, 0, 6, 0, 0, 1, 0, 0, 6, 0, 0, 0, 1,
	1, 0, 0, 0, 0, 1, 1, 1, 1, 1, 1, 0, 0, 0, 6, 0, 0, 0, 0, 0, 5, 5, 0, 0, 0, 0, 0, 0, 0, 6, 0, 0, 1, 0, 0, 6, 0, 0, 0, 1,
	1, 0, 0, 0, 0, 0, 5, 0, 0, 5, 0, 0, 0, 0, 6, 0, 0, 0, 0, 0, 6, 6, 0, 0, 0, 0, 0, 0, 0, 1, 0, 0, 1, 0, 0, 1, 0, 0, 0, 1,
	1, 0, 0, 0, 0, 0, 6, 0, 0, 6, 0, 0, 0, 0, 6, 0, 0, 0, 0, 1, 1, 1, 1, 0, 0, 0, 0, 0, 0, 1, 0, 0, 1, 0, 0, 1, 0, 0, 0, 1,
	1, 0, 0, 0, 0, 0, 6, 0, 0, 6, 0, 0, 0, 0, 6, 1, 1, 1, 1, 1, 1, 1, 1, 1, 1, 0, 0, 0, 0, 5, 0, 0, 5, 0, 0, 5, 0, 0, 0, 1,
	1, 1, 1, 1, 1, 1, 1, 1, 1, 1, 1, 1, 1, 1, 1, 1, 1, 1, 1, 1, 1, 1, 1, 1, 1, 1, 1, 1, 1, 1, 1, 1, 1, 1, 1, 1, 1, 1, 1, 1,
)

ROOM_N_NEIGHBORS(1)
ROOM_NEIGHBORS(room::roompicker)
ROOM_N_WALLS(4)
ROOM_WALLS(
	Wall(Vec(10, 22.5), 0),
	Wall(Vec(10, 37.5), 0),
	Wall(Vec(30, 37.5), 0),
	Wall(Vec(30, 22.5), 0),
)


ROOM_INIT(
	new Tilemap(HERE);
	new BGColor(HERE, pos, Vec(width, height), 0x7f7f7fff);
	new Door(HERE, pos+Vec(1, 21), room::roompicker, room::roompicker->pos+Vec(8.5, 1));
	new Rat(HERE, pos+Vec(13, 21));
	new Rat(HERE, pos+Vec(17, 21));
	new Rat(HERE, pos+Vec(29, 21));
	new Rat(HERE, pos+Vec(32, 21));
	new Crate(HERE, pos+Vec(10.5, 17));
	new Crate(HERE, pos+Vec(6.5, 5));
	new Crate(HERE, pos+Vec(7.5, 5));
	new Crate(HERE, pos+Vec(7, 6));
	new Crate(HERE, pos+Vec(21.5, 15));
	new Crate(HERE, pos+Vec(22.5, 15));
	new Crate(HERE, pos+Vec(22, 16));
	new Crate(HERE, pos+Vec(20.5, 3));
	new Crate(HERE, pos+Vec(21.5, 4));
	new Crate(HERE, pos+Vec(21.5, 3));
	new Crate(HERE, pos+Vec(20.5, 4));
	new Crate(HERE, pos+Vec(1.5, 1));
	new Crate(HERE, pos+Vec(2.5, 1));
//	ROOM_OBJECT(obj::mousehole, 15.5, 21, 0, 0, 1, 0, 0)
//	ROOM_OBJECT(obj::mousehole, 27.5, 21, 0, 0, 1, 0, 0)
	new Patroller(HERE, pos+Vec(29.5, 12));
	new Patroller(HERE, pos+Vec(11.5, 8));
)

ROOM_END


