
ROOM_BEGIN

ROOM_POS(0, 15)
ROOM_WIDTH(40)
ROOM_HEIGHT(30)
ROOM_TILES(
	0x0001,0x0001,0x0001,0x0001,0x0001,0x0001,0x0001,0x0001,0x0001,0x0001,0x0001,0x0001,0x0001,0x0001,0x0001,0x0001,0x0001,0x0001,0x0001,0x0001,0x0001,0x0001,0x0001,0x0001,0x0001,0x0001,0x0001,0x0001,0x0001,0x0001,0x0001,0x0001,0x0001,0x0001,0x0001,0x0001,0x0001,0x0001,0x0001,0x0001,
	0x0001,0x0000,0x8004,0x8002,0x0000,0x0000,0x0000,0x0000,0x0000,0x0000,0x0005,0x0000,0x0000,0x0000,0x0005,0x0000,0x0000,0x0000,0x0005,0x0000,0x0000,0x0000,0x0005,0x0000,0x0000,0x0000,0x0005,0x0000,0x0000,0x0000,0x0005,0x0000,0x0000,0x0000,0x0002,0x0004,0x0000,0x0000,0x0000,0x0001,
	0x0001,0x8004,0x8003,0x0000,0x0000,0x0000,0x0000,0x0000,0x0000,0x0000,0x0006,0x0000,0x0000,0x0000,0x0006,0x0000,0x0000,0x0000,0x0006,0x0000,0x0000,0x0000,0x0006,0x0000,0x0000,0x0000,0x0006,0x0000,0x0000,0x0000,0x0006,0x0000,0x0000,0x0000,0x0000,0x0003,0x0004,0x0000,0x0000,0x0001,
	0x0001,0x8003,0x0000,0x0000,0x0000,0x0000,0x0000,0x0000,0x0000,0x0000,0x0006,0x0000,0x0000,0x0000,0x0006,0x0000,0x0000,0x0000,0x0006,0x0000,0x0000,0x0000,0x0006,0x0000,0x0000,0x0000,0x0006,0x0000,0x0000,0x0000,0x0006,0x0000,0x0000,0x0000,0x0000,0x0000,0x0003,0x0004,0x0000,0x0001,
	0x0001,0x0000,0x0000,0x0000,0x0000,0x0000,0x0000,0x0000,0x0000,0x0000,0x0006,0x0000,0x0000,0x0000,0x0006,0x0000,0x0000,0x0000,0x0006,0x0000,0x0000,0x0000,0x0006,0x0000,0x0000,0x0000,0x0006,0x0000,0x0000,0x0000,0x0006,0x0000,0x0000,0x0000,0x0000,0x0000,0x0000,0x0003,0x0004,0x0001,
	0x0001,0x0001,0x0001,0x0000,0x0000,0x0000,0x0000,0x0000,0x0000,0x0000,0x0006,0x0000,0x0000,0x0000,0x0006,0x0000,0x0000,0x0000,0x0006,0x0000,0x0000,0x0000,0x0006,0x0000,0x0000,0x0000,0x0006,0x0000,0x0000,0x0000,0x0006,0x0000,0x0000,0x0000,0x0000,0x0000,0x0000,0x0000,0x0003,0x0001,
	0x0001,0x0000,0x0005,0x0000,0x0000,0x0000,0x0000,0x0000,0x0000,0x0000,0x0006,0x0000,0x0000,0x0000,0x0006,0x0000,0x0000,0x0000,0x0006,0x0000,0x0000,0x0000,0x0006,0x0000,0x0000,0x0000,0x0006,0x0000,0x0000,0x0000,0x0006,0x0000,0x0000,0x0000,0x0000,0x0000,0x0000,0x0000,0x0000,0x0001,
	0x0001,0x0000,0x0006,0x0000,0x0000,0x0000,0x0000,0x0000,0x0000,0x0000,0x0006,0x0000,0x0000,0x0000,0x0006,0x0000,0x0000,0x0000,0x0006,0x0000,0x0000,0x0000,0x0006,0x0000,0x0000,0x0000,0x0006,0x0000,0x0000,0x0000,0x0006,0x0000,0x0000,0x0000,0x0000,0x0000,0x0000,0x0000,0x0000,0x0001,
	0x0001,0x0000,0x0006,0x0000,0x0000,0x0000,0x0000,0x0000,0x0000,0x0000,0x0006,0x0000,0x0000,0x0000,0x0006,0x0000,0x0000,0x0000,0x0006,0x0000,0x0000,0x0000,0x0006,0x0000,0x0000,0x0000,0x0006,0x0000,0x0000,0x0000,0x0006,0x0000,0x0000,0x0000,0x0000,0x0000,0x0000,0x0000,0x0000,0x0001,
	0x0001,0x0001,0x0001,0x0000,0x0000,0x0000,0x0000,0x0001,0x0001,0x0001,0x0001,0x0001,0x0001,0x0001,0x0001,0x0001,0x0001,0x0001,0x0001,0x0001,0x0000,0x0001,0x0001,0x0001,0x0001,0x0001,0x0001,0x0001,0x0001,0x0001,0x0001,0x0001,0x0001,0x0000,0x0000,0x0000,0x0000,0x0000,0x0000,0x0001,
	0x0001,0x8002,0x0000,0x0000,0x0000,0x0000,0x0000,0x0000,0x0005,0x0000,0x0000,0x0000,0x0005,0x0000,0x0000,0x0000,0x0000,0x0000,0x0000,0x0000,0x0000,0x0000,0x0000,0x0000,0x0000,0x0000,0x0000,0x0000,0x0000,0x0000,0x0000,0x0002,0x0004,0x0000,0x0000,0x0000,0x0000,0x0000,0x0000,0x0001,
	0x0001,0x0000,0x0000,0x0000,0x0000,0x0000,0x0000,0x0000,0x0006,0x0000,0x0000,0x0000,0x0006,0x0000,0x0000,0x0000,0x0000,0x0000,0x0000,0x0000,0x0000,0x0000,0x0000,0x0000,0x0000,0x0000,0x0000,0x0000,0x0000,0x0000,0x0000,0x0000,0x0003,0x0004,0x0000,0x0000,0x0000,0x0000,0x0000,0x0001,
	0x0001,0x0000,0x0000,0x0000,0x0000,0x0000,0x0000,0x0000,0x0006,0x0000,0x0000,0x0000,0x0006,0x0000,0x0000,0x0000,0x0000,0x0000,0x0000,0x0000,0x0000,0x0000,0x0000,0x0000,0x0000,0x0000,0x0000,0x0000,0x0000,0x0000,0x0000,0x0000,0x0000,0x0003,0x0004,0x0000,0x0000,0x0000,0x0000,0x0001,
	0x0001,0x0000,0x0000,0x0000,0x0000,0x0001,0x0001,0x0001,0x0001,0x0001,0x0001,0x0001,0x0001,0x0001,0x0000,0x0000,0x0000,0x0000,0x0000,0x0000,0x0000,0x0000,0x0000,0x0000,0x0000,0x0000,0x0000,0x0000,0x0000,0x0000,0x0000,0x0000,0x0001,0x0001,0x0001,0x0001,0x0001,0x0001,0x0001,0x0001,
	0x0001,0x0000,0x0000,0x0000,0x0000,0x8004,0x8002,0x0000,0x0005,0x0000,0x0000,0x0000,0x0005,0x0000,0x0000,0x0000,0x0000,0x0000,0x0000,0x0000,0x0000,0x0000,0x0000,0x0000,0x0000,0x0000,0x0000,0x0000,0x0000,0x0000,0x0000,0x0000,0x0001,0x8004,0x8002,0x0000,0x0000,0x0000,0x0002,0x0001,
	0x0001,0x0000,0x0000,0x0000,0x8004,0x8003,0x0000,0x0000,0x0006,0x0000,0x0000,0x0000,0x0006,0x0000,0x0000,0x0000,0x0000,0x0000,0x0001,0x0001,0x0001,0x0001,0x0001,0x0001,0x0000,0x0000,0x0000,0x0000,0x0000,0x0000,0x0000,0x0000,0x8004,0x8003,0x0000,0x0000,0x0000,0x0000,0x0000,0x0001,
	0x0001,0x0000,0x0000,0x8004,0x8003,0x0000,0x0000,0x0000,0x0006,0x0000,0x0000,0x0000,0x0006,0x0000,0x0000,0x0000,0x0000,0x0000,0x0001,0x8002,0x0000,0x0000,0x0002,0x0001,0x0000,0x0000,0x0000,0x0000,0x0000,0x0000,0x0000,0x8004,0x8003,0x0000,0x0000,0x0000,0x0000,0x0000,0x0000,0x0001,
	0x0001,0x0001,0x0001,0x0001,0x0001,0x0000,0x0000,0x0000,0x0006,0x0000,0x0000,0x0000,0x0006,0x0000,0x0000,0x0000,0x0000,0x0000,0x0001,0x0000,0x0000,0x0000,0x0000,0x0001,0x0000,0x0000,0x0000,0x0000,0x0000,0x0000,0x8004,0x8003,0x0000,0x0000,0x0000,0x0000,0x0000,0x0000,0x0000,0x0001,
	0x0001,0x8004,0x8002,0x0000,0x0000,0x0000,0x0000,0x0000,0x0006,0x0000,0x0000,0x0000,0x0006,0x0000,0x0000,0x0000,0x0000,0x0000,0x0006,0x0000,0x0000,0x0000,0x0000,0x0005,0x0000,0x0000,0x0000,0x0000,0x0000,0x0001,0x0001,0x0001,0x0001,0x0001,0x0001,0x0001,0x0001,0x0000,0x0000,0x0001,
	0x0001,0x8003,0x0000,0x0000,0x0000,0x0000,0x0000,0x0000,0x0001,0x0004,0x0000,0x0000,0x0006,0x0000,0x0000,0x0000,0x0000,0x0000,0x0006,0x0000,0x0000,0x0000,0x0000,0x0006,0x0000,0x0000,0x0000,0x0000,0x0001,0x0001,0x0000,0x0000,0x0005,0x0000,0x0000,0x0005,0x0000,0x0000,0x0000,0x0001,
	0x0001,0x0000,0x0000,0x0000,0x0000,0x0000,0x0000,0x0000,0x0000,0x0003,0x0004,0x0000,0x0006,0x0000,0x0000,0x0000,0x0000,0x0001,0x0001,0x0001,0x0001,0x0001,0x0001,0x0001,0x0001,0x0000,0x0000,0x0001,0x0001,0x0005,0x0000,0x0000,0x0006,0x0000,0x0000,0x0006,0x0000,0x0000,0x0000,0x0001,
	0x0001,0x0000,0x0000,0x0000,0x0000,0x0000,0x0000,0x0000,0x0000,0x0000,0x0003,0x0004,0x0006,0x0000,0x0000,0x0000,0x0000,0x0000,0x0001,0x0001,0x0001,0x0001,0x0001,0x0001,0x0000,0x0000,0x0000,0x0000,0x0000,0x0006,0x0000,0x0000,0x0006,0x0000,0x0000,0x0006,0x0000,0x0000,0x0000,0x0001,
	0x0001,0x0000,0x0000,0x0000,0x0000,0x0000,0x0000,0x0000,0x0000,0x0000,0x0000,0x0001,0x0001,0x0001,0x0001,0x0000,0x0000,0x0000,0x0000,0x0002,0x0001,0x0001,0x8002,0x0000,0x0000,0x0000,0x0000,0x0000,0x0000,0x0006,0x0000,0x0000,0x0006,0x0000,0x0000,0x0006,0x0000,0x0001,0x0001,0x0001,
	0x0001,0x0000,0x0000,0x0000,0x0000,0x0000,0x0000,0x0000,0x0000,0x0000,0x8004,0x8002,0x0000,0x0000,0x0005,0x0000,0x0000,0x0000,0x0000,0x0000,0x0001,0x0001,0x0000,0x0000,0x0000,0x0000,0x0000,0x0000,0x0000,0x0006,0x0000,0x0000,0x0001,0x0000,0x0000,0x0006,0x0000,0x0000,0x0002,0x0001,
	0x0001,0x0000,0x0000,0x0000,0x0000,0x0000,0x0000,0x0000,0x0000,0x8004,0x8003,0x0000,0x0000,0x0000,0x0006,0x0000,0x0000,0x0000,0x0000,0x0000,0x0001,0x0001,0x0000,0x0000,0x0000,0x0000,0x0000,0x0000,0x0000,0x0006,0x0000,0x0000,0x0001,0x0000,0x0000,0x0006,0x0000,0x0000,0x0000,0x0001,
	0x0001,0x0000,0x0000,0x0000,0x0000,0x0001,0x0001,0x0001,0x0001,0x0001,0x0001,0x0000,0x0000,0x0000,0x0006,0x0000,0x0000,0x0000,0x0000,0x0000,0x0005,0x0005,0x0000,0x0000,0x0000,0x0000,0x0000,0x0000,0x0000,0x0006,0x0000,0x0000,0x0001,0x0000,0x0000,0x0006,0x0000,0x0000,0x0000,0x0001,
	0x0001,0x0000,0x0000,0x0000,0x0000,0x0000,0x0005,0x0000,0x0000,0x0005,0x0000,0x0000,0x0000,0x0000,0x0006,0x0000,0x0000,0x0000,0x0000,0x0000,0x0006,0x0006,0x0000,0x0000,0x0000,0x0000,0x0000,0x0000,0x0000,0x0001,0x0000,0x0000,0x0001,0x0000,0x0000,0x0001,0x0000,0x0000,0x0000,0x0001,
	0x0001,0x0000,0x0000,0x0000,0x0000,0x0000,0x0006,0x0000,0x0000,0x0006,0x0000,0x0000,0x0000,0x0000,0x0006,0x0000,0x0000,0x0000,0x0000,0x0001,0x0001,0x0001,0x0001,0x0000,0x0000,0x0000,0x0000,0x0000,0x0000,0x0001,0x0000,0x0000,0x0001,0x0000,0x0000,0x0001,0x0000,0x0000,0x0000,0x0001,
	0x0001,0x0000,0x0000,0x0000,0x0000,0x0000,0x0006,0x0000,0x0000,0x0006,0x0000,0x0000,0x0000,0x0000,0x0006,0x0001,0x0001,0x0001,0x0001,0x0001,0x0001,0x0001,0x0001,0x0001,0x0001,0x0000,0x0000,0x0000,0x0000,0x0005,0x0000,0x0000,0x0005,0x0000,0x0000,0x0005,0x0000,0x0000,0x0000,0x0001,
	0x0001,0x0001,0x0001,0x0001,0x0001,0x0001,0x0001,0x0001,0x0001,0x0001,0x0001,0x0001,0x0001,0x0001,0x0001,0x0001,0x0001,0x0001,0x0001,0x0001,0x0001,0x0001,0x0001,0x0001,0x0001,0x0001,0x0001,0x0001,0x0001,0x0001,0x0001,0x0001,0x0001,0x0001,0x0001,0x0001,0x0001,0x0001,0x0001,0x0001,
)

ROOM_N_NEIGHBORS(1)
ROOM_NEIGHBORS(room::roompicker)
ROOM_N_WALLS(4)
ROOM_WALLS(
	Circle(Vec(10, 22.5), 0),
	Circle(Vec(10, 37.5), 0),
	Circle(Vec(30, 37.5), 0),
	Circle(Vec(30, 22.5), 0),
)


ROOM_INIT(
	static Tilemap a1 (HERE);
	static BGColor a2 (HERE, pos, Vec(width, height), 0x7f7f7fff);
	static Door a3 (HERE, pos+Vec(1, 21), room::roompicker, room::roompicker->pos+Vec(8.5, 1));
	static Rat a4 (HERE, pos+Vec(13, 21));
	static Rat a5 (HERE, pos+Vec(17, 21));
	static Rat a6 (HERE, pos+Vec(29, 21));
	static Rat a7 (HERE, pos+Vec(32, 21));
	static Crate a8 (HERE, pos+Vec(10.5, 17));
	static Crate a9 (HERE, pos+Vec(6.5, 5));
	static Crate a10 (HERE, pos+Vec(7.5, 5));
	static Crate a11 (HERE, pos+Vec(7, 6));
	static Crate a12 (HERE, pos+Vec(21.5, 15));
	static Crate a13 (HERE, pos+Vec(22.5, 15));
	static Crate a14 (HERE, pos+Vec(22, 16));
	static Crate a15 (HERE, pos+Vec(20.5, 3));
	static Crate a16 (HERE, pos+Vec(21.5, 4));
	static Crate a17 (HERE, pos+Vec(21.5, 3));
	static Crate a18 (HERE, pos+Vec(20.5, 4));
	static Crate a19 (HERE, pos+Vec(1.5, 1));
	static Crate a20 (HERE, pos+Vec(2.5, 1));
//	ROOM_OBJECT(obj::mousehole, 15.5, 21, 0, 0, 1, 0, 0)
//	ROOM_OBJECT(obj::mousehole, 27.5, 21, 0, 0, 1, 0, 0)
	static Patroller a21 (HERE, pos+Vec(29.5, 12));
	static Patroller a22 (HERE, pos+Vec(11.5, 8));
)

ROOM_END


