
ROOM_BEGIN

ROOM_WIDTH(30)
ROOM_HEIGHT(20)
ROOM_TILES(
  1,  1,  1,  1,  1,  1,  1,  1,  1,  1,  1,  1,  1,  1,  1,  1,  1,  1,  1,  1,  1,  1,  1,  1,  1,  1,  1,  1,  1,  1,
  1,  0,  0, -4, -2,  0,  0,  0,  0,  0,  0,  0,  0,  0,  0,  0,  0,  0,  0,  0,  0,  0,  0,  0,  0,  0,  0,  0,  0,  1,
  1,  0, -4, -3,  0,  0,  0,  0,  0,  0,  0,  0,  0,  0,  0,  0,  0,  0,  0,  0,  0,  0,  0,  0,  0,  0,  0,  0,  0,  1,
  1, -4, -3,  0,  0,  0,  0,  0,  0,  0,  0,  0,  0,  0,  0,  0,  0,  0,  0,  0,  0,  0,  0,  0,  0,  0,  0,  0,  0,  1,
  1, -3,  0,  0,  0,  0,  0,  0,  0,  0,  0,  0,  0,  0,  0,  0,  0,  0,  0,  0,  0,  0,  0,  0,  0,  0,  0,  0,  0,  1,
  1,  0,  0,  0,  0,  0,  0,  0,  0,  0,  0,  0,  0,  0,  0,  0,  0,  0,  0,  0,  0,  0,  0,  0,  0,  0,  0,  0,  0,  1,
  0,  0,  0,  0,  0,  0,  0,  0,  0,  0,  0,  0,  0,  0,  0,  0,  0,  0,  0,  0,  0,  0,  0,  1,  1,  1,  1,  1,  1,  1,
  0,  0,  0,  0,  0,  0,  0,  0,  0,  0,  0,  0,  0,  0,  0,  0,  0,  0,  0,  0,  0,  0,  0,  0,  5,  0,  0,  0,  2,  1,
  0,  0,  0,  0,  0,  0,  0,  0,  0,  1,  1,  1,  1,  1,  0,  0,  0,  0,  0,  0,  0,  0,  0,  0,  6,  0,  0,  0,  0,  0,
  1,  1,  1,  1,  1,  1,  0,  0,  0,  0,  5,  0,  5,  0,  0,  0,  0,  0,  0,  0,  0,  0,  0,  0,  6,  0,  0,  0,  0,  0,
  1,  1,  1,  1,  1,  1,  0,  0,  0,  0,  6,  0,  6,  0,  0,  0,  0,  0,  0,  0,  0,  0,  0,  0,  6,  0,  0,  0,  0,  0,
  1,  1,  1,  1,  1,  1,  0,  0,  0,  0,  6,  0,  6,  0,  0,  0,  0,  0,  0,  1,  1,  1,  1,  1,  1,  1,  1,  1,  1,  1,
  1,  0,  0,  0,  0,  5,  0,  0,  0,  0,  6,  0,  6,  0,  0,  0,  0,  0,  0,  1,  1,  1,  1,  1,  1,  1,  1,  1,  1,  1,
  1,  0,  0,  0,  0,  6,  0,  0,  1,  1,  1,  1,  1,  1,  1,  0,  0,  0,  0,  5,  0,  0,  0,  0,  0,  0,  0,  0,  0,  1,
  1,  0,  0,  0,  0,  6,  0,  0,  1,  1,  1,  1,  1,  1,  1,  0,  0,  0,  0,  6,  0,  0,  0,  0,  0,  0,  0,  0,  0,  1,
  1,  0,  0,  0,  0,  1,  1,  1,  1,  1,  1,  1,  1,  1,  1,  0,  0,  0,  0,  6,  0,  0,  0,  0,  0,  0,  0,  0,  0,  1,
  0,  0,  0,  0,  0,  5,  0,  0,  0,  5,  0,  0,  0,  5,  0,  0,  0,  0,  0,  6,  0,  0,  0,  0,  0,  0,  0,  0,  0,  1,
  0,  0,  0,  0,  0,  6,  0,  0,  0,  6,  0,  0,  0,  6,  0,  0,  0,  0,  0,  6,  0,  0,  0,  0,  0,  0,  0,  0,  0,  1,
  0,  0,  0,  0,  0,  6,  0,  0,  0,  6,  0,  0,  0,  6,  0,  0,  0,  0,  1,  1,  0,  0,  0,  0,  0,  0,  0,  0,  0,  1,
  1,  1,  1,  1,  1,  1,  1,  1,  1,  1,  1,  1,  1,  1,  1,  1,  1,  1,  1,  1,  1,  1,  1,  1,  1,  1,  1,  1,  1,  1
)

ROOM_NNEIGHBORS(1)
ROOM_NEIGHBORS(
	room::test1
)
ROOM_WALLS(TOP|RIGHT|BOTTOM)
/*
ROOM_NOBJECTS(6)
ROOM_OBJECTS(
	ROOM_OBJECT(obj::entrance, 1.500000, 11.000000, 0.000000, 0.000000, 0, 0, 0)
	ROOM_OBJECT(obj::entrance, 29.500000, 9.000000, 0.000000, 0.000000, 0, 0, 1)
	ROOM_OBJECT(obj::exit, -1.000000, 10.000000, 1.000000, 4.000000, 0, room::test4, 1)
	ROOM_OBJECT(obj::exit, -1.000000, 0.000000, 1.000000, 4.000000, 0, room::test4, 1)
	ROOM_OBJECT(obj::exit, 30.000000, 8.000000, 1.000000, 4.000000, 0, room::lotsodanger, 0)
	ROOM_OBJECT(obj::flyer, 16.500000, 4.500000, 0, 0, 0, 0, 0)
)

ROOM_COLOR(127, 127, 127, 255)
ROOM_BG(0)
ROOM_BGM(1)
*/
ROOM_END

